###############################
#                            $#
#                             #
#       #                     #
#       #                     #
#       #######$              #
#       #                     #
#                             #
#                             #
#                             #
#              $              #
#            ####             #
#                             #
#      #                      #
#      #           $          #
#      # $                    #
#      #                      #
#      #                      #
#                             #
#                             #
###############################